...................#
.....#####.....#....
...............#....
...............#....
....................
....................
......#.............
....................
....................
....................
.#..................
....................
....................
....................
....................
.....##########.....
....................
.................#..
....................
#..................#