....................
.....###########....
...............#....
...####........#....
........####...#....
....#..........#....
...............#....
...............#....
.##########....#....
.....##........#....
......#........#....
#.....#........#....
#.....#........#....
#..............#....
#...................
#...................
#..#########..#.....
#...................
#...................
#..................#