....................
......###########...
...##.......####....
....................
...####.............
...#................
...#................
...#................
...#.........#..####
...#................
...#.........##.....
...#................
...#................
...#................
....................
......##############
....................
..#####.............
....................
...........#########