....................
.....###########....
...............#....
....########...#....
...............#....
...............#....
...............#....
....##.........#....
...............#....
...............#....
...............#....
#..............#....
#..............#....
#..............#....
#...................
#......#####........
#...................
#...####............
#...................
#..................#