####################
####################
...................#
..........#........#
...................#
...................#
...................#
...................#
...................#
...................#
...................#
..#................#
...................#
...................#
...................#
...................#
................#..#
...................#
####################
####################