....................
...............####.
..#...#.............
..#...#.............
..#..##.............
..#...#.............
..##..#.............
..#...#.............
..#...#.............
..#...#.............
........#...........
....................
...........####.....
....................
.........##.........
....................
....................
......####..##......
....................
#######....#........